BBBBBBBBBBBBBBBBBBBB
B    M  BHB        B
B       BBB        B
B            O     B
B                  B
B O            O   B
B                  B
B                  B
B                  B 
BBBBBBBB   BBBBBBBBB
B    B             B 
B    B             B
B    B             B
B    BBBBB         B
B                  B
B            O     B
B                  B 
B                  B
B O                B
BBBBBBBBBBBBBBBBBBBB