BBBBBBBBBBBBBBBBBBBB
B    BHB  M        B
B    BBB           B
B                  B
B                  B
B                  B
B    O      O      B
BBBBB        BBBBBBB                  
B                  B 
B  O            O  B
B       BBB        B 
B       BBB        B
B       BBB        B
B       BBB        B
B    BBBBBBBBB     B
B                  B
B  O     O     O   B 
B                  B
B        O         B
BBBBBBBBBBBBBBBBBBBB